(supertux-level
  (version 3)
  (name (_ "DifferentTux Reimagined"))
  (author "Sophie Ball")
  (license "CC-BY-SA 4.0 International")
  (allow-item-pocket "on")
  (icon "")
  (icon-locked "")
  (sector
    (name "main")
    (init-script "import(\"levels/dt_reimagined/world1.nut\");")
    (ambient-light
      (color 1 1 1)
    )
    (level
      (z-pos 50)
      (level "sl_welcome_snowy_land.stl")
      (x 19)
      (y 95)
    )
    (level
      (z-pos 50)
      (level "sl_tux_road.stl")
      (x 22)
      (y 91)
    )
    (level
      (z-pos 50)
      (level "sl_red_charm.stl")
      (x 37)
      (y 91)
    )
    (level
      (z-pos 50)
      (x 37)
      (y 87)
    )
    (level
      (z-pos 50)
      (x 45)
      (y 87)
    )
    (level
      (z-pos 50)
      (x 45)
      (y 83)
    )
    (level
      (z-pos 50)
      (x 27)
      (y 83)
    )
    (level
      (z-pos 50)
      (x 34)
      (y 83)
    )
    (level
      (z-pos 50)
      (x 27)
      (y 85)
    )
    (level
      (z-pos 50)
      (x 32)
      (y 87)
    )
    (level
      (z-pos 50)
      (x 33)
      (y 78)
    )
    (level
      (z-pos 50)
      (x 32)
      (y 71)
    )
    (level
      (z-pos 50)
      (x 32)
      (y 75)
    )
    (level
      (z-pos 50)
      (x 47)
      (y 72)
    )
    (level
      (z-pos 50)
      (x 55)
      (y 66)
    )
    (level
      (z-pos 50)
      (x 53)
      (y 65)
    )
    (level
      (z-pos 50)
      (x 48)
      (y 62)
    )
    (level
      (z-pos 50)
      (x 44)
      (y 64)
    )
    (level
      (z-pos 50)
      (x 43)
      (y 66)
    )
    (level
      (z-pos 50)
      (x 43)
      (y 71)
    )
    (level
      (z-pos 50)
      (x 21)
      (y 70)
    )
    (level
      (z-pos 50)
      (x 22)
      (y 83)
    )
    (level
      (z-pos 50)
      (x 17)
      (y 72)
    )
    (level
      (z-pos 50)
      (x 12)
      (y 67)
    )
    (level
      (z-pos 50)
      (x 15)
      (y 60)
    )
    (level
      (z-pos 50)
      (x 18)
      (y 59)
    )
    (level
      (z-pos 50)
      (x 22)
      (y 66)
    )
    (music
      (name "Music_Object")
      (file "/music/antarctic/salcon.music")
    )
    (tilemap
      (solid #f)
      (z-pos -100)
      (name "Water_Tiles")
      (width 100)
      (height 100)
      (tiles -10000 1)
    )
    (tilemap
      (solid #t)
      (z-pos 0)
      (name "Main_Tiles")
      (width 100)
      (height 100)
      (tiles -5815 0 90001 -12 90002 90003 -83 0 90001 -2 90002 90014 -9 90005 90012 -2 90005 90013 90003 -5 0 90001 -14 90002 90003 -61 0 90004 -10 90005 90016 90017 -4 90005 90013 90003 -2 0 90001 90002 90014 -4 90005 90016 90017 -8 90005 90013 90003 -59 0 90001 90014 -6 90005 90012 -3 90005 90019 90020 -5 90005 90013 -2 90002 90014 -6 90005 90019 90020 -9 90005 90013 90002 90003 -57 0 90004 -4 90005 90018 90005 90016 90017 -9 90005 90012 -6 90005 90015 -16 90005 90013 90003 -55 0 90001 90014 -6 90005 90019 90020 -6 90005 90016 90017 -6 90005 90015 -19 90005 90013 90003 -54 0 90004 -15 90005 90019 90020 -27 90005 90013 90003 -53 0 90004 -2 90005 90018 -25 90005 90016 90017 -15 90005 90013 90003 -52 0 90004 -9 90005 90018 -18 90005 90019 90020 -16 90005 90006 -52 0 90004 -4 90005 90016 90017 -8 90005 90018 90005 90012 -19 90005 90015 -2 90005 90016 90017 -5 90005 90006 -52 0 90004 -4 90005 90019 90020 -2 90005 90018 -9 90005 90016 90017 -19 90005 90019 90020 -5 90005 90006 -52 0 90007 90011 -6 90005 90012 -10 90005 90019 90020 -4 90005 90016 90017 90005 90018 -17 90005 90010 90009 -53 0 90004 -23 90005 90019 90020 -19 90005 90006 -54 0 90004 -27 90005 90015 -15 90005 90010 90009 -54 0 90007 90011 -10 90005 90018 -6 90005 90012 -9 90005 90016 90017 -13 90005 90006 -56 0 90007 90011 90018 -9 90005 90016 90017 -2 90005 90012 -11 90005 90019 90020 -12 90005 90010 90009 -56 0 90001 90014 -10 90005 90019 90020 -12 90005 90018 -4 90005 90016 90017 -8 90005 90010 90009 -56 0 90001 90014 -6 90005 90016 90017 -22 90005 90019 90020 -8 90005 90006 -57 0 90004 -3 90005 90016 90017 -2 90005 90019 90020 -8 90005 90016 90017 -8 90005 90015 -13 90005 90013 90003 -55 0 90001 90014 -3 90005 90019 90020 -6 90005 90018 -5 90005 90019 90020 -5 90005 90016 90017 -10 90005 90016 90017 -4 90005 90006 -55 0 90004 -14 90005 90016 90017 -9 90005 90019 90020 -7 90005 90018 -2 90005 90019 90020 -4 90005 90006 -55 0 90004 -14 90005 90019 90020 -2 90005 90012 -24 90005 90006 -55 0 90004 90005 90018 -7 90005 90016 90017 -32 90005 90006 -55 0 90004 -3 90005 90016 90017 -4 90005 90019 90020 -5 90005 90012 -4 90005 90016 90017 -5 90005 90016 90017 -11 90005 90016 90017 90006 -55 0 90004 -3 90005 90019 90020 -7 90005 90018 -8 90005 90019 90020 -5 90005 90019 90020 -11 90005 90019 90020 90006 -55 0 90007 90011 -36 90005 90015 -5 90005 90006 -56 0 90004 -9 90005 90012 -12 90005 90016 90017 -14 90005 90016 90017 -2 90005 90006 -56 0 90007 90011 -3 90005 90012 -12 90005 90016 90017 -3 90005 90019 90020 -4 90005 90018 -2 90005 90016 90017 -5 90005 90019 90020 -2 90005 90006 -57 0 90004 90005 90018 90005 90016 90017 -6 90005 90018 -4 90005 90019 90020 -12 90005 90019 90020 -8 90005 90010 90009 -57 0 90007 90011 -2 90005 90019 90020 -2 90005 90015 -4 90005 90018 -27 90005 90006 -59 0 90007 90011 -11 90005 90016 90017 -12 90005 90016 90017 -6 90005 90016 90017 -3 90005 90006 -60 0 90007 90011 -10 90005 90019 90020 -5 90005 90016 90017 -5 90005 90019 90020 -6 90005 90019 90020 -3 90005 90006 -60 0 90001 90014 90018 90012 -3 90005 90015 -11 90005 90019 90020 -17 90005 90010 90009 -59 0 90001 90014 -31 90005 90015 -4 90005 90010 90009 -59 0 90001 90014 90005 90016 90017 -10 90005 90015 -2 90005 90016 90017 -2 90005 90015 -6 90005 90016 90017 -6 90005 90010 90008 90009 -60 0 90004 -2 90005 90019 90020 -7 90005 90018 -5 90005 90019 90020 -6 90005 90015 -2 90005 90019 90020 90005 90010 -4 90008 90009 -62 0 90007 90011 -4 90005 90018 -2 90005 90016 90017 -2 90005 90010 -18 90008 90009 -68 0 90007 90011 -2 90005 90012 -3 90005 90019 90020 90005 90010 90009 -88 0 90007 90011 -7 90005 90010 90009 -90 0 90007 90011 -5 90005 90010 90009 -92 0 90007 -5 90008 90009 -177 0)
    )
    (tilemap
      (solid #t)
      (z-pos 1)
      (width 100)
      (height 100)
      (tiles -5916 0 10 -4 20 11 -91 0 10 -2 20 15 -4 0 21 -9 0 54 -81 0 21 -7 0 21 -9 0 55 -80 0 10 15 -7 0 21 -9 0 21 -12 0 10 -7 20 11 -59 0 21 -8 0 21 -9 0 21 -12 0 21 -7 0 21 -58 0 10 15 -8 0 14 11 -8 0 14 11 -11 0 21 -7 0 21 -58 0 21 -10 0 21 -9 0 21 -10 0 10 15 -7 0 14 -2 20 11 -55 0 21 -10 0 21 -9 0 21 -10 0 21 -11 0 21 -55 0 14 20 11 -8 0 21 -9 0 21 -10 0 21 -11 0 21 -57 0 21 -7 0 10 15 -9 0 21 -10 0 21 -10 0 10 15 -57 0 21 -7 0 21 -10 0 21 -10 0 21 -10 0 21 -58 0 14 20 11 -5 0 21 -10 0 21 60 61 62 -7 0 21 -10 0 21 -60 0 21 -5 0 21 -10 0 21 63 64 65 -7 0 21 -10 0 21 -60 0 14 20 13 -3 20 15 -10 0 21 66 67 68 -7 0 14 -3 20 13 -6 20 15 -62 0 21 -14 0 21 -14 0 21 -69 0 21 -14 0 21 -13 0 10 15 -69 0 21 -14 0 21 -13 0 21 -70 0 21 -14 0 21 -13 0 21 -70 0 21 -14 0 21 -13 0 21 -70 0 21 -14 0 14 20 11 -11 0 21 -70 0 21 -16 0 21 -11 0 21 -70 0 14 20 11 -14 0 21 -11 0 21 -72 0 21 -14 0 21 -11 0 21 -72 0 21 -14 0 21 -11 0 21 -72 0 12 -2 20 13 -4 20 13 -6 20 16 -10 20 13 15 -72 0 21 -2 0 21 -4 0 21 -17 0 21 -73 0 21 -2 0 21 -4 0 21 -17 0 21 -73 0 21 -2 0 21 -4 0 21 -17 0 21 -73 0 21 -2 0 21 -4 0 14 -9 20 13 -7 20 17 -73 0 21 -2 0 21 -14 0 21 -7 0 21 -73 0 21 -2 0 21 -14 0 21 -7 0 21 -73 0 21 -2 0 21 -14 0 21 -7 0 21 -73 0 12 -2 20 16 -14 20 16 -7 20 15 -73 0 21 -99 0 21 -99 0 21 -99 0 21 -99 0 21 -99 0 21 -99 0 52 -99 0 53 -80 0)
    )
    (worldmap-spawnpoint
      (z-pos 50)
      (name "main")
      (x 19)
      (y 99)
    )
  )
  (tileset "/levels/dt_reimagined/images/dt_worldmap.strf")
)
